360
 _________
| | |____ |
| |___    |
|  _  | |_|
| | | |   |
|_|_____|_|
