_______________________________________
|                                     |
|                                     |
|    r                                |
|                                     |
|_____________________________________|
