 _________
| | |____ |
| |___ x  |
|r o  | |_|
| | |O|  X|
|_|_____|_|
360
