 _______________________________ 
|  _________________________    |
| |    _   _  |_  ____________| |
| | |_   _  |_  |_____       _| |
| |_  |_  |_  | |  _____| |_  | |
| | |_  |_  |_  |_____   _|  _| |
| |   |_  |_  |_|  _  |_  |_  | |
| | |_  |_  |_____   _|  _|  _| |
|  ___|_____| |   | |  _| |_  | |
| |   |   | |  ___|  _| | |  _| |
| | | | | | |_______| | | |_  | |
| | | | | | | |  _____| | |  _| |
| | | | | | | | |  _____| |_  | |
| | | | | | |   | |  _____|  _| |
|   | | | | | | | |   |   |_  | |
| | |___|___| | | | |___|_____| |
|S|_____________________________|

