 _______________________________ 
|___    |   | |   |     |  ___  |
|  _  |  _|_  | | | | |     |   |
|   | |     | | | | | | | | | | |
| |_| |_|_|_   _|_____| | |_  | |
|   |___|_  |_|        _|_  |___|
|_| | __  __| | | | |  ___|___  |
|  _|_________|___|_|___  |  _  |
|  _________|     |  ___  |_  |_|
| |  _____  | |___|___      |   |
| | |_____  | | |   | | |_|_  | |
| |  _  __|___|  _|   |  _  |   |
| |_|_______________|___|_  | | |
| |___    |  _  | |  ___  |_|_  |
|  _  | |___| | __|_______  | | |
| | | |   | ____  |___     _|_  |
|S|_____|_______|_______|_______|

