 _______________________________
| |  _________  |_      |       |
| |_        | |  _. | | |_| | | |
| | | | | | | |  ___|_|  ___|_| |
| | | | | | | |  _____.  ___  | |
| |   | | | | |  _____.  ___  | |
| | | |       |  _____.  ___  | |
| |_| | | | | |_______________| |
|  _    | | | |    _________  | |
| | | | | | | |___|___________  |
| | | | | | | |  _____.  ___  | |
| | | |       |  _____.  ___  | |
| |   | | | | |  _____.  ___  | |
| | | | | | | |  _____.  _____| |
| |_| | | | | |  _. | |  _  | | |
| |  _______|_|  _  | | | | | | |
|S|_____________|_______|_______|

