 _____________
|             |
|             |
|  l       d  |
|             |
|             |
|             |
|             |
|             |
|             |
|  s       r  |
|_____________|
360
