 _______________________________ 
| . . . . . . . . . . . . . . . |
| . . . . . . . . . . . . . . . |
| . . . . . . . . . . . . . . . |
|_______________________  . . . |
|  ___  ._____________  | . . . |
| |  _  .___________  | | . . . |
| | |_    |    _____| | | . . . |
| | |   |   | | F   | | | . . . |
| | | |___|___|___| | | | . . . |
| | | |  ___________| | | . . . |
|  _|  _|  _   _|   |___| . . . |
| |  _|  _|  _| | |     | . . . |
| | | | |  _|   |_. | | | . . . |
| |_________  | |___| | | . . . |
| . |_______  ._______| | . . . |
|S|_____________________|_______|

