 _____________________________
|__   |  |   _____    _____|  |
|   __|     |     |  |  .  |  |
|  |  |  |   __|__|  |__   |  |
|  |__       __   |   __   |  |
|  |__   |__   |__|  |   __|  |
|   _____   |__   |  |_____   |
|  |        |__    ________   |
|  |  |__|     |  |   _____   |
| s|  |   __|      __|   __   |
|__|__|________|_____|_____|__|

