 _____________
|             |
|             |
|  d   d   d  |
|             |
|             |
|             |
|             |
|    u   u    |
|_____________|
360
