 _____________
|             |
|             |
|             |
|             |
|             |
|             |
|             |
|     u       |
|_____________|
360
