 _____________
|             |
|             |
|      d      |
|             |
|             |
|             |
|             |
|      u      |
|_____________|
360
