 _____________
|             |
|             |
|  d d d d d  |
|             |
|             |
|             |
|             |
|  u u u u u  |
|_____________|
360
