 _________________
|  _________|     |
| |  _____  | |___|
| | |_____  | | | |
| |  _  __|___|  _|
| |_|____________ |
| |___    |  _  | |
|  _  | |___| | __|
| | | |   | ____  |
|S|_____|_______|_|
